1111111111111111111111111111111111
1E00C000000C000C00000C00C00C000001
1010010100100000101001C00000010101
101C01C01010101000100100C000010111
1P00C0000C00C0000C00000CC00C0001C1
1111111111111111111111111111111111
