1111111111111111111111111111111
1C1C1C1C1C1C1C1C1C1C1C1C1C1C1C1
1C1C1C1C1C1C1C1C1C1C1C1C1C1C1C1
1C1C1C1C1C1C1C1C1C1C1C1C1C1C1C1
1C1C1C1C1C1C1C1C1C1C1C1C1C1C1C1
1C1C1C1C1C1C1C1C1C1C1C1C1C1C1C1
1C1C1C1C1C1C1C1C1C1C1C1C1C1C1C1
1C1C1C1C1C1C1C1C1C1C1C1C1C1C1C1
1C1C1C1C1C1C1C1C1C1C1C1C1C1C1C1
1C1C1C1C1C1C1C1C1C1C1C1C1C1C1C1
1C1C1C1C1C1C1C1C1C1C1C1C1C1C1C1
1C1C1C1C1C1C1C1C1C1C1C1C1C1C1C1
1C1C1C1C1C1C1C1C1C1C1C1C1C1C1C1
1C1C1C1C1C1C1C1C1C1C1C1C1C1C1C1
1C1C1C1C1C1C1C1C1C1C1C1C1C1C1C1
1C1C1C1C1C1C1C1C1C1C1C1C1C1C1C1
1C1C1C1C1C1C1C1C1C1C1C1C1C1C1C1
1C1C1C1C1C1C1C1C1C1C1C1C1C1C1C1
1C1C1C1C1C1C1C1C1C1C1C1C1C1C1C1
1C1C1C1C1C1C1C1C1C1C1C1C1C1C1C1
1C1C1C1C1C1C1C1C1C1C1C1C1C1C1C1
1C1C1C1C1C1C1C1C1C1C1C1C1C1C1C1
1C1C1C1C1C1C1C1C1C1C1C1C1C1C1C1
1C1C1C1C1C1C1C1C1C1C1C1C1C1C1C1
1C1C1C1C1C1C1C1C1C1C1C1C1C1C1C1
1C1C1C1C1C1C1C1C1C1C1C1C1C1C1C1
1C1C1C1C1C1C1C1C1C1C1C1C1C1C1C1
1C1C1C1C1C1C1C1C1C1C1C1C1C1C1C1
1C1C1C1C1C1C1C1C1C1C1C1C1C1C1C1
1C1C1C1C1C1C1C1C1C1C1C1C1C1C1C1
1C1C1C1C1C1C1C1C1C1C1C1C1C1C1C1
1C1C1C1C1C1C1C1C1C1C1C1C1C1C1C1
1C1C1C1C1C1C1C1C1C1C1C1C1C1C1C1
1C1C1C1C1C1C1C1C1C1C1C1C1C1C1C1
1C1C1C1C1C1C1C1C1C1C1C1C1C1C1C1
1C1C1C1C1C1C1C1C1C1C1C1C1C1C1C1
1C1C1C1C1C1C1C1C1C1C1C1C1C1C1C1
1C1C1C1C1C1C1C1C1C1C1C1C1C1C1C1
1C1C1C1C1C1C1C1C1C1C1C1C1C1C1C1
1EP0000000000000000000000000001
1111111111111111111111111111111
