111111111111111111111111111111111111111111111111111111111111
1CCCCCCCCC1CCCCCCCCCCCCCCCCC1CCCCC1CCCCCCCCCCC1CCCCCCCCCCCC1
1CCCCC1CCCCCCCCCCCCCCCCCCCCCCCCCCCCCCCCCCCCCCCC11CCCCCCCCCC1
1CCCCCCCCCCCCCCCCCCCCCCCCCCCCCCCCC1CCCCCCCCCCCCC1CCCCCCCCCC1
1CCCCCCCC1CC1C1CCCCCC11CC1CCCC1C1CCCCCCCCCCCCCCC1CCCCCCCCCC1
1CCC1C1CCCCCCCCCCCCC1CCCCCCCC1CCCCCCCCCCCCCCCCCC111111C11CC1
1CCC11CCCCCCCCCCC1CCCCCCC1CCCCCCCCC1C1CCCCCCCCCCCCCCCCCCCCC1
1CCCCCCCCCCCCCCCCC11CCCCCCCCCCCCCCCCCCCCCC11111CCCCCCCCCC111
1CCCCCCC1C1CC1CCCC1CCCCCCC11CCCCCCCCCCCCCC1CCCCCCCCCCCCC1CC1
1CCC11C1CCCCCCCCCCCCCCCCCCCCCCCCCCCCCCCCCC1CCCCCCCCCCCCCCCC1
1CCCCCCCCC1CCCCCCCCCCCCCCC11CCCCCCCCCCCCCC1CCCCCCCCCCCCCCCC1
1CCCCCCCCC1CCCCCCCCCCCCCCCCCCCCCCCCCCCCCCC1CCCCCCCCCCCCCCCC1
1CCCCCCCCCC1CCCCCCCCCCCCCCCCCCCCCCCCCCCCCC1CCCCCCCCCCCCCCCC1
1CCCCCCCCCC1CCCCCCCCCCCCCCCCCCCCCC1CCCCCCC1111111111CCCCCCC1
1CCC1CCCCCCC111C11CCCCCCCCCCCCCCCCCC1CCCCCCCCCCCCCCC1CCCCCC1
1CCCCCCCCCCCCCCCCCC1CCCCCCCCCCCCCCCCCCCCCCCCCCCCCCCC1CCCCCC1
1CCC11CCCCCCCCCCCCC1CC11111CCCCCCCCCCCCCCCCCCCCCCCCC1CCCCCC1
1CCCCCCCCCCCCCCCCCCCCCCCCCCCCCCCCCCCCCCCCCCCCCCCCCCC1CCCCCC1
1CCCC1CCCCCCCCCCCCCCCCCCCC11CCCCCCCC1CCCCCCCCCCCCCCC1CCCCCC1
1CCCC1CCCCCCCCCCCCCCCCCCCC1CCCCCCCCCCCCCC1CCC1CCCCCC1CCCCCC1
1CCCC1CCCCCCCCCC1CCCCCCCC1CCCCCCCCCCCCCCCCCCC1CCCCCC11111111
1CCCCCCCCCCCCCCCCCCCCCCCC1CCCCCCCCCCCCCCCCCCCCCCCCCCCCCCCCC1
1CCCC1CCCCCCCCCC1CCCCCCCC1CCCCCCCCCC1CCCCCCCCCCCC1CCCCCCCCC1
1CCCC1CCCCCC1C11CCCCCCCCC1CC1C11CC1CCCCCCCCCCCCCCCCCCCCCCCC1
1CCCCC111C1CCCCCCCCCCCCCCCCCCCCCCCCCCCCCCCCCCCCCC111CCCCCCC1
1CCCCCCCCCCCCCCCCCCCCCCCCCCCCCCCCCCC1CCCCCCCCCCCCCCCCC1CCCC1
1CCCC1CC1C11CCCCCCCCCCCCCCCCCCCCCCCCCC1CCC1CCCC1C111111CCCC1
1CCCC1CCCCCCCCCCC1CCCCCCCCCCCCCCCCCCCCCC1C1CCCC1CCCCCCCCCCC1
1CCCC11CCCCCCCCCC1CCCCCCCCCCCC1111CCCCCCCCCCCCC1CCCCCCCCCCC1
1CCCCC1CCCC0CCCCCCCCCCCCCCCCCCPCCCCCCCCC11C11C1CCCCCCCCCCCC1
1CCCCCCCCCCCCCCCC1CCCCCCCCCCCC1CCCCCCCCC1CCCCCCCCCCCCCCCCCC1
1CCCCCCCCCCCCCCCC1CCCCCCCCCCCC1CCCCCCCC1CCCCCCCCCCCCCCCCCCC1
1CCCCC11C11C1C1C1CCCCCCCCCCCCC1CCCC1C11CCCCCCCCCCCCCCCCCCCC1
1ECCCCCCCCCCCCCCCCCCCCCCCCCCCCCCCCCCCCCCCCCCCCCCCCCCCCCCCCC1
111111111111111111111111111111111111111111111111111111111111
