111111111111111111111111111111111111111111111111111111111111
1000000000100000C0000000000010000010000000000010000000000001
100C001000000000000000C0000000000000C000C0000001100000000001
1000000000000C0000000000000000000010000000000000100000000001
100000000100101000000110010000101000C0000C000000100C00000001
1000101000C0000000001000000001000000000000000000111111011001
10001100000000000100000C0100000000C1010000000000000000000001
100C0000000000000C11C00000000C000000000000111110000000000111
100000001010C1000010000000110000000000000010C000000000001001
100011010C0000000000000000000000000000000C100000000000C00001
10000000001000C0000000000C1100000000000000100000000000000001
10000000001000000000000000000000C000000000100000C00C00000001
10000000000100000000C000000000000000000000100000000000000001
1000000C000100000000000000000000001000000C111111111100000001
100010000000111011000000C00000000000100000000000C00010000001
100000000000000000010000000000000000000000000000000010000001
10001100000C00000001001111100000000000000000C000000010000001
10000000000000000000000000C0000C0000000000000000000010C00001
1000010000000000C000000000110000000010000C00000000C010000001
1000010000000000000C0000001000000000000001000100000C1000C001
10000100000000001000000C0100000000C000C000000100000011111111
10000000000C000000000000010000000000000000000C00000000000001
100001000000000010000000010000000000100C00000000010000000001
10000100000C101100000000010010110010000000000C00000000000001
10000011101000000000000000000000000000000000000001110000C001
100000000000000000000000000000000000100000C00000000000100001
10000100101100000000000C000000000000001000100C01011111100001
100001000000000001000000000000000000000010100001000000000001
100001100000000001000000000000111100000000000001000000000001
10000010000000000000C000000000P00000000011011010C0000000C001
10000000000C00000100000000000010000000001000000000C000000001
100000000000000001000000000000100000000100000000000000000001
100000110110101010000000000000100001011000000000000000C00001
1E00000000000000000000C0000000000000000000000000C00000000001
111111111111111111111111111111111111111111111111111111111111
