111111111111
100000000001
101000C10101
101E01010101
10110P000101
100000000101
100110011101
100000C00101
100000000101
101111011101
101C10000001
100010011001
111111110001
1C0000000001
111111111111
