1111111111111111111111111111111111
10000000C0000000000000000000000001
101001010010000010100100C000010101
101E010010101010001001000000010101
10000000000000000000P0000000000001
1111111111111111111111111111111111
