1111111
10P00C1
1111001
1E00001
1111111
