111111111
10P00C101
111100001
1E00001C1
1000C0001
111111111
